NO /home/aregenia/school21/cub3d/txts_xpm/anime1.xpm
SO /home/aregenia/school21/cub3d/txts_xpm/anime2.xpm
WE /home/aregenia/school21/cub3d/txts_xpm/anime3.xpm
EA /home/aregenia/school21/cub3d/txts_xpm/anime4.xpm

F 255,0,98
C 3,213,255

        1111111111111111111111111
        1000000000110000000000001
        1011000001110000000000001
        1001000000000000000000001
111111111011000001110000000000001
100000000011000001110111111111111
11110111111111011100000010001
11110111111111011101010010001
11000000110101011100000010001
10000000000000001100000010001
10000000000000001101010000001
11000001110101011111011110N01
11110111 1110101 101111010001
11111111 1111111 111111111111
